~name=Frogie's Delight, delay=500, gravity=1, music=level.wav, red=108, green=137, blue=254
----a-------
---a--------
---a--------
----a-------
------a-----
-------a----
-------a----
------a-----
-----a------
---a--------
--a---------
-a----------
-a----------
--a---------
----a-------
------a-----
--------a---
---------a--
---------a--
--------a---
-------a----
-----a------
